11111111111111111
11P0000N00000N001
1111110000N000111
1110000N000000001
11000000N00000N01
1111110000N000111
1110000N0N00000E1
1111110000N001011
1110000N000000001
11111111111111111