11101111111111111
11P000000000M0001
10000000C00000101
111000000000000E1
11111111111111111