11111111111111111111111111
11P000000000CE100000000001
10100000C00011110000000001
111000000000N0000000000001
11000000N00111100000000001
10000000C000C01000000N0001
11000100C000000100000NNN01
1100000000000000000000N001
10100000C00000100000000001
111000000000N0000000000001
11000000N00111100000000001
11111111111111111111111111