11111111111111111
11P00000000000001
10000000C00000101
111000000000N0001
11000000N00100011
10000000C00E10101
1110N000000000001
10000000C00000101
11111111111111111