11111111111111111111111111
11P00000000000E10000000001
10100000C00000100000000001
111000000000N0000000000001
11000000N00111100000000001
10000000C000C0100000000001
11000100C00000010000000001
11000000000000000000000001
10100000C00000100000000001
111000000000N0000000000001
11000000N00111100000000001
10000000C000C0100000000001
11000100C00000010000000001
11000000000000000000000001
10100000C00000100000000001
111000000000N0000000000001
11000000N00111100000000001
10000000C000C0100000000001
11000100C00000010000000001
11000000100000000000000000
101000000C1000010000000001
11111111111111111111111111