11111111111111111
11P000000000N0001
1000000C000000101
111000000000000E1
11111111111111111