11111111111111111
11P0000N00000N001
111111C000N000111
1110000N0000000E1
11111111111111111