11111111111111111
11P000000000N0001
111111C1111111111
111000000000000E1
11111111111111111