11111111111111111
11P0000N00000N001
1111110000N000111
1110000N000000001
1100000N00000N001
1111110000N000111
1110000N000000E01
1100000N00000N001
1111110000N000111
1110000N000000001
1100000N00000N001
1111110000N000111
1110000N000000001
1100000N00000N001
1111110000N000111
1110000N000000001
1100000N00000N001
1111110000N000111
1110000N000000001
11111111111111111