11111111111111111
1100000N00000N001
1111110000N000111
1110000N000000001
11000000N00000N01
11111100C0N000111
1110000N0N00000E1
1111110000NC01011
1110000N000000001
11111111111111111