11111111111111111
11P0000N00000N001
111111C000N000111
1110000N000000001
11000000N00000N01
111111C000N000111
1110000N0NC0000E1
111111C000N001N11
1110000N000000001
11111111111111111